  ##########                     
###        ##################### 
##                             # 
 #                             # 
 #       ################      ##
 #                              #
 #                              #
 ##                             #
  #            @               ##
 ##                            # 
 #          ####   ####        # 
 #          #  #   ## #       ## 
 #          ####    ###       #  
 #                            #  
 #                            ## 
 ##       ##############       # 
  #                            ##
  ##                           # 
   ############################# 